
█████████████████████████████████████████████████████████████████████████████████ 
  █     █   █           █     █               █ █       █   █       █         █ █ 
█ █ █ ███ █ █ ███████ █ ███ ███ ███████████ █ █ █ ███ █ █ █ █ ███ █ ███████ █ █ █ 
█ █ █     █   █   █   █ █   █   █     █   █ █   █ █   █   █ █ █   █         █   █ 
█ █████████ ███ █ █ ███ █ █ █ ███ ███ █ █ █ █████ █ ███████ █ █ ███████████████ █ 
█ █       █     █ █ █     █ █ █     █   █ █   █   █ █       █ █         █   █   █ 
█ █ █████ █████████ █████████ █ █████████ ███ █ ███ ███ ███████████ ███ █ █ █████ 
█ █ █     █       █           █ █     █     █ █   █   █ █         █   █ █ █ █   █ 
█ █ █ █████ █████ █████ ███████ █ ███ █ ███ █ ███ ███ █ █████ ███ ███ █ █ █ █ █ █ 
█   █ █   █   █       █       █ █ █     █   █       █ █       █ █   █ █   █   █ █ 
█████ █ █ █ █ ███████ ███████ █ █ █████ █████████████ █████████ ███ █ ███████ █ █ 
█   █ █ █ █ █     █ █ █   █   █ █   █ █ █         █   █         █ █ █   █   █ █ █ 
█ █ █ █ █ ███████ █ █ █ ███ ███████ █ █ █ ███████ █ ███████ ███ █ █ █ ███ █ ███ █ 
█ █   █ █       █ █   █ █   █     █ █   █       █ █ █       █   █ █ █ █   █     █ 
█ █████ ███████ █ ███ █ █ █████ █ █ █ █████████ █ █ █ █████████ █ █ ███ ███████ █ 
█     █     █   █   █ █ █       █   █   █   █   █   █         █ █ █     █   █   █ 
█████ █████ ███ ███ █ █ █████████ ███████ █ █ █████████ █████ █ █ ███████ █ █ ███ 
█   █     █   █   █ █ █   █     █ █       █ █     █   █     █ █           █ █   █ 
███ █████ ███ ███ █ █ █ ███ ███ █ █ ███████ █ ███ █ █ ███████ ███████████ █████ █ 
█       █ █   █ █ █ █ █       █   █ █       █ █   █ █       █       █     █   █ █ 
█ █████ █ █ ███ █ █ █ ███████████ █ ███ ███████ ███ ███████ █ █████ ███████ █ █ █ 
█ █   █ █ █   █   █ █       █   █ █   █ █     █ █         █ █ █   █         █   █ 
█ █ █ █ █ ███ █ ███ ███████ █ █ █████ █ █ ███ █ █ █████████ █ █ █ ███████████████ 
█   █ █ █     █ █       █   █ █ █     █   █ █ █   █         █ █ █   █     █     █ 
█ ███ █████████ █ █████ █ ███ █ █ █████████ █ █ ███ █████████ █ ███ █ ███ █ ███ █ 
█ █ █         █ █ █ █   █     █ █ █ █     █   █   █   █   █     █   █   █ █ █   █ 
█ █ █████ ███ █ █ █ █ █████████ █ █ █ █ ███ █████ ███ █ █ ███████ ███ █ █ ███ ███ 
█ █   █   █ █ █ █   █ █   █   █   █ █ █ █   █   █ █ █   █   █   █ █ █ █ █   █   █ 
█ █ █ █ ███ █ █ █████ █ █ █ ███████ █ █ █ ███ █ █ █ ███████ █ ███ █ █ █ ███ ███ █ 
█   █ █ █ █   █     █ █ █ █ █     █   █   █ █ █ █   █     █ █   █ █   █   █   █ █ 
█ █████ █ █ ███████ █ █ █ █ █ ███ █ ███████ █ █ ███ █████ █ █ █ █ ███ ███ ███ █ █ 
█ █     █ █ █     █ █   █ █   █ █   █   █     █           █ █ █ █   █ █   █     █ 
█ █ █████ █ █ ███ █ █████ █ ███ ███████ █ ███████ █████████ █ █ ███ ███ █ █████ █ 
█ █ █   █   █   █ █       █   █       █   █     █ █         █ █   █ █   █ █   █ █ 
█ █ █ █ █████ ███ ███████████ █ █ ███ █████ ███ █ █ █████████████ █ █ █████ █ █ █ 
█ █   █       █   █     █   █ █ █   █       █ █ █ █   █ █         █ █       █ █ █ 
█ █████████████ ███ █ █ █ █ █ █████ █████████ █ █ ███ █ █ █ █████ █ █████████ █ █ 
█ █     █       █   █ █   █ █     █ █ █         █ █ █ █ █ █ █     █   █       █ █ 
█ █ ███ █ ███████ ███ █████ █████ █ █ █ █████████ █ █ █ █ █ █████████ █ ███████ █ 
█ █ █   █         █ █ █     █   █ █ █   █       █   █ █   █ █       █ █ █       █ 
█ █ █ █████████████ █ ███ █████ █ █ █ ███ █████ ███ █ █ ███ █ ███ ███ █ █████ ███ 
█   █ █           █ █   █     █ █   █ █   █     █   █ █   █     █ █   █     █   █ 
█████ ███████ ███ █ ███ █████ █ █████ █ █████ ███ ███ █████████ █ █ ███ ███ ███ █ 
█   █         █       █   █ █   █     █     █ █     █       █ █ █ █ █ █ █ █   █ █ 
███ ███████████ █████████ █ ███ █ █████████ █ █████ ███████ █ █ █ █ █ █ █ ███ █ █ 
█     █   █   █ █         █     █ █         █     █   █   █ █   █   █ █     █ █ █ 
█ █████ █ █ █ █ █ █████████ █████ █ █████████████ ███ █ █ █ ███ █████ █████ █ ███ 
█ █     █   █   █       █   █     █ █     █     █ █     █ █   █ █     █     █   █ 
█ █ ███████████████████ █ ███ █████ █ ███ █ ███ █ █ ███████ █ █ █ ███ █ ███████ █ 
█   █               █   █ █   █     █   █ █ █ █   █ █     █ █ █ █   █ █   █     █ 
█ █████ █████████ █ █ █████ ███ █ ███████ █ █ ███████ ███ ███ █ ███ █ ███ █ █████ 
█ █   █     █     █ █   █   █   █ █       █ █         █ █     █ █   █     █     █ 
█ █ █ ███ ███ █████ ███ █ ███ ███ █ █ █████ █ █ ███████ ███████ █ █████████████ █ 
█   █   █ █   █     █   █   █ █   █ █       █ █ █ █       █     █ █     █     █ █ 
███████ ███ ███ █████ █████ █ █ ███ █████████ █ █ █ █ █████ █████ ███ █ █████ █ █ 
█   █       █     █   █   █ █ █ █ █ █     █   █ █ █ █       █         █       █ █ 
█ █ █████████ █████ █ █ █ █ ███ █ █ ███ █ █ ███ █ █ █████████████████████████ █ █ 
█ █         █ █     █ █ █ █   █ █ █   █ █     █ █ █             █       █     █ █ 
█ █████████ ███ █ █████ █ ███ █ █ ███ ███████ █ █ █████████████ █ █████ █ █████ █ 
█   █   █ █     █ █   █ █   █   █     █   █ █ █ █       █     █ █ █     █ █ █   █ 
███ █ █ █ ███████ █ █ █ ███ █████ █████ █ █ █ █ █ █ ███ ███ ███ █ █ █████ █ █ █ █ 
█   █ █ █         █ █ █   █     █ █     █ █ █ █ █ █   █   █   █ █ █   █   █ █ █ █ 
█ ███ █ █ █████████ █ ███ ███ ███ █████ █ █ █ █ █ ███ ███ █ █ █ █████ █ ███ █ ███ 
█ █   █ █   █       █   █ █ █   █   █   █ █   █ █   █ █   █ █ █     █       █   █ 
█ █ ███ █████ █████████ █ █ ███ ███ █ ███ ███ █ █████ █ █████ █████ ███████████ █ 
█   █ █       █         █ █ █     █   █ █   █ █   █   █         █ █           █ █ 
█ ███ █████████ ███████ █ █ █ █████████ ███ █████ █ ███████████ █ ███████████ █ █ 
█   █   █     █ █ █     █   █           █   █     █ █     █         █       █ █ █ 
███ █ █ █████ █ █ █ ███████ ███████████ █ ███ █████ █ █████ ███████ █ █████ █ █ █ 
█ █ █ █       █ █   █     █ █     █     █     █     █ █     █ █   █ █ █     █   █ 
█ █ █ ███████ █ █████ ███ █ █ █ ███ ███ ███████████ █ █ █████ █ █ ███ █ ███ ███ █ 
█ █ █     █ █ █     █ █ █   █ █   █ █   █       █   █         █ █     █ █ █ █   █ 
█ █ █████ █ █ █████ █ █ █████████ █ █████ █ ███ █ █████████████ ███████ █ █ █ ███ 
█   █     █   █ █   █ █     █   █ █   █   █   █ █ █     █       █     █ █   █ █ █ 
█ ███ █████ ███ █ ███ █ █ █ █ █ █ ███ █ █████ █ █ █ ███ █ ███████ ███ █ █████ █ █ 
█   █   █ █ █   █     █ █ █ █ █   █   █   █ █ █ █ █ █ █   █       █ █ █ █     █ █ 
███ ███ █ █ █ █ █████████ █ █ █████ █ ███ █ █ █ █ █ █ ███████ █ ███ █ █ █ █████ █ 
█ █ █   █ █   █ █         █   █     █   █ █ █ █   █ █       █ █ █   █ █   █     █ 
█ █ █ ███ █████ ███████ █████ █ █████████ █ █ █████ █████ █ ███ █ ███ █████ ███ █ 
█     █                 █     █             █             █     █           █   █ 
█████████████████████████████████████████████████████████████████████████████████ 
                                                                                  